10 03 01 
XXXXXXXXXX
X..J...G.X
X.MJ...G.X
X..J...G.X
X..J...G.X
XXXXXXXXXX
