10 09 04 
XXXXXXXXXX
XXXXXX...X
X..J.....X
X..JXXX.XX
XXGJG.G.GX
XX.JX....X
XX.MXXXXXX
XX..XXXXXX
XXXXXXXXXX
